abbos - jiddiy, vazmin, dovyurak, jasoratli.
abror - a`lo xulqli, yaxshi tarbiyali, samimiy.
adham - qora belgi, dog` bilan tug`ulgan chaqaloqa aytiladi.
azamat - martabali, qo`rqmas.
aziz - qadri qimmat, hurmatli.
azim - ulug`vorlik, kotta, kuchli.
akbar - va akobir - birlik, ikkinchisi ko`plik, ulug`lik, ulkanlik.
akmal - mukammallik, benuqsonlik.
akram - ko`rkam, oktam, jomard.
alimardon - martaba, mardlik, mardona.
alisher - yuksaklik martabalilik sher arslondek qo`rqmas.
anvar - yorug`lik, nurlilik.
asad - 5 chi oyning nomi.
asil - aslzodalardan, oli toifa insonlar
asomiddin - dinga tayanchi bo`lish.
asror - sirlilik, yashirin, maxfiylik
asqad - baxtiyorlik, saodatmandlik.
afzal - ustunlik, yaxshilik, yuqori bo`lish.
ahmad - maqtovga sazovar.
ahror - olijanoblik, muruvvatlilik, himmatli bo`lish.
adiba - adib (yozuvchi) tushunchasidan; adida - aslida: adad – ko`p, jami.
aziza - bebaho, qimmatli; yuksak martabali, hurmatga loyiq;
alomat - badanida biron belgi yoki nishon bilan tug`ilgan.
alfiya - ming. umri uzoq bo`lsin degan ma`noda berilgan ism.
amina - aynan: omonlikda saqlanuvchi, ya`ni muhofaza qilingan.
anora - qizil xol, nor bilan tug`ilgan qizga shunday ism berilgan.
asal - bu shirinlik qur`oni karimda ham bir necha o`rinda zikr qilingan va uning shifo- i baxshligi
afro`z - yorug`, nurli, shu`lali, kuydiruvchi.
aqida - ismning qat`iy ishonch, ixlos, e`tiqod ma`nolari bor.


badriddin - din to`lin oyi; din mashali.
bakir - o`rganuvchi, tadqiqotchi.
baxtiyor - baxt, hursandchilik, istiqbol yor bo`lgan.
baxshi – mualim, o`qituvchi.
bahrom - mirix yulduzining nomi.
bahruz - juda yaxshi, juda qutlug`; ro`za - kunida tug’ilganlarga aytiladi.
behzod - aslzoda ma`nosida.
bilol - 3 kunlik oy.
bobur – Yo`lbars deb talqin qiladilar.
bozor - bozor kunida tug`ilgan bolalar shunday ismga ega bo’lishgan.
bunyod - asos ma’nosida keladi.
burhon - hujjat, dalillik.
burxon - hujjat, dalillik.
barno - aynan: yosh, navjuvon; chiroyli, xushbichim, xushqad.
barchin - shoyi, ipak mato, ya`ni ipakdek qiz.
bashira - xushxabar, yaxshiliklar, saodat elchisi. 
bahor - umuman qiz farzandlarga bunday ism berish keng tarqalgan, bahor faslida tug`ilgan chaqaloqlarga ham shunday ism beriladi.
begim - bek so`zidan.
bonu - xonim, xotun, begim, bibi, mahbuba. 

davlat - boylik, saodatli ma`nosida.
davron - umri quvonchda o`tsin ma`nosida.
dehqon - qishloq rahbari.
diyor - yurt farzandi.
dilmurod - niyati amalga oshgan ota-onalar qo’yadigan ism.
dilshod - ko’ngillarga quvonch keltirgan bola.
doniyor - uquvlilik, epchillik.
doston - ovoza,dovrug`li.
do`nan – to`rt yashar ot.
davriya - davr, zamon farzandi degan ma`noda bo`lsa kerak.
damina - sabr-toqatli, quntli, irodasi mustahkam.
dilafro`z - dilni quvontiruvchi, dilni shodlantiruvchi,
dilbar - dilga yaqin, suyukli.
dinora - arablar ham, yunonlar ham dinor deganda tillani tushunadilar.
dono - bilimli, aqlli, zukko. 
dunyo - odam, jahon; boylik. 

eldor - qabila, elat boshlig`i;
eshon - aynan: u kishi; katta odam. 
elyor - el bilan birga bo`lsin, degan ma`noda beriladigan ism.
elzoda - ulg`ayib el farzandi bo`lsin, degan ma`noda beriladigan ism.
elnora - nor kabi elning yukini ko`tarsin, og`irini engil qilsin ma`nosida beriladigan ism.

fazilat - yaxshi xislatlarga, chiroyli xulqatvorga ega bo`lsin degan niyatda beriladigan ism.
farangiz - nur sochuvchi, ziyo taratuvchi, ziyoli.
farzixon – qonun-qoidalarga, rasmrusumlar va an`analarga amal qiluvchi.
farida - ehtimol pardali bo`lyb tug`ilgan chaqaloqlarga shunday ism qo`yilsa kerak.
farog`at - o`zbek oilalarida keng tarqalgan ismlardan biri.
farhod - Aqlli, zukko, fahm-farosatli, dono yigit. Alisher Navoiyning “Farhod va Shirin” asari qahramoni Farhoddek tog‘ni talqon qiluvchi bo‘lsin
feruza - g`olib, xushbaxt.
fotima - ko`krakdan ajratilgan.
fayz - yoqimli, muloyim; jozibali, •1 ko`rkam.
fayyoz - oliyhimmat, mehribon.
farziddin - din farz deb biluvchi.
farid - yakkalik, yolg`iz, yagona;
farmon - buyruq, amr. hudoning irodasi.
farrux - baxtli, baxtiyor.
fahmiddin - dinni fahmlovchi. 
firdavs - sakkizinchi jannatning nomi; bog`, ko`kalamzor.
fitrat - aqlu farosatli, dono.
fozil - bilimdon, dono, donishmand. 

gul - g`ulg`uncha, daraxt guli, ochilgan gul; yuz, chehraga nisbatan.
go`zal - benihoya chiroyli.


habiba - do`st, yaqin; suyukli,e`tiborli, qadrli qiz.
haitbeka – hayit arafasida yoki hayit bayrami kuni tugilgan chaqaloqqa beriladigan ism.
hakima - ulgayib dono va aqlli bo`lsin degan niyatda beriladigan ism.
halima - muloyim, mehribon, rahmdil.
hafiza - himoya qiluvchi, qo`riqlovchi, o`z panohida asrovchi
hosila - ota-onaning farzandi ham hosil hisoblanadi.
hulkar - etti qaroqchi turkumidagi (surayyo) yulduzi.
humo - afsonaviy qush.
hurbeka - hur-ozod, erkin, go`zal.
haydar - dovyurak, qudratli. 
hayit - hayit kuni tug`ilgan bolaga shunday ism berilgan. 
hayrat - aynan: hayratlanish, taajjub. 
hakim - bilimdon, aqlli, dono, donishmand. 
halim - muloyim, mehribon.
hamdam - do`st, o`rtoq. 
hamza - o`tkir, achchiq, kuydiruvchi, 
hamid - maqtovchi, madh etuvchi. 
hasan - yaxshi, tuzuk; chiroyli, sohib- jamol.
hidoyat - to`g`ri yo`lga boshlovchi, to`g`ri yo`l topuvchi. 
hiloliddin - dinning yangi, ko`rkam oyi.
hoji - ziyoratchi, sig`inuvch
homid - shukur qiluvchi, qanoat qiluvchi, sabr-toqatli. 
hosil - meva, samara, natija. 
hoshim - maydalovchi, ushatuvchi; non sindiruvchi. 
huvaydo - belgili, oshkora, ravshan, aniq.
humoyun - qutlug`, muborak, noyob, tengsiz.
hurmat - izzat. ma`nosida.
husayn - hasan ismi bilan bir xil ma`noda.

ibodat - doimo taqvo bilan shug`ullanuvchi, hudoga sig`inuvchi.
ikroma - izzat, hurmat.
indira – oy degani. hindistonda dinlar ko`p, shulardan biri veda dinidir.
inobat - hudo iltijolarni qabul qilib bergan qizaloq.
iroda - chidamli, toqatli;
islomiya - bu ismni islom diniga sig`inuvchi yoki ixlosmandi, deb talqin qilish mumkin.
ismigul - ya`ni bu qizaloqning ismi gul, degan ma`noda.
iffat - pokiza, ma`suma, bokira.
ibrohim - xalqlar otasi - ma’nosida.
ikrom - izzatli, hurmatli, ehtiromli, obro` yoki tuxfa.
ilyos - hudoning kuchi, qudrati yoki xalqlarning sevimlisi.
ilhom - ruhlanishlik, jo`sh urish; intilish.
imom - boshlovchi, etakchilik, oldinda turuvchi
imron - tirik, barhayot.
inobiddin - din marhamati, himmati.
inoyat - xayrixoh, ko`mak, ehson.
iskandar - mardlik, qo`rqmaliks, dovyurak yoki muhofaza qiluvchi.
islomiddin - dinning ko`rki, naqshi, husni.
islom - musulmon din nomi.
ismad - pok, begunoh, ma`sumlik.
ismoil - xudo eshitdi.
isomiddin - din tutqichi, madali, ko`magi.
isroil - hudo yo`lida kurashuvchi.
isfan - isiriq, shamsiya yilining ikkinchi oyi.
iftixor - faxrli, g`ururli.
iffatullo - hudoning - pokdomon bandasi. degan ma`noda. ismning boshqa shakli uch- ramaydi.
ixlosiddin - dinga ixlosmand ma`no- sida.
iqboliddin - din iqboli.
iqroriddin - dinni tan oluvchi.

jamila - go`zal, zebo.
joziba - qarang: jazbiya.
juvona - bunday ism berish ham noto`gri. Chunki o`zbeklarda juvon deganda turmush ko`rgan ayol tushuniladi. 
jumagul - juma kuni tug`ilgan qizchalarga shunday ism berilgan. 
juraxon - o`zbek tilidagi “yo`ldosh”, hamroh” ma`nolarida.
javlon - chiroyli shaxdam qadam tashlovchi.
javohir - bebaholik, qimmat.
jaloliddin - din ulug`ligi, azamatligi, din masalasida azamat, kuchli bo`lsin.
jamoliddin - din jamoli; din barkamolligi, ravnaqi.
janobiddin - ostona, bo`sag`a, dargoh,
jasur - mard, jasoratli.
ja`far - go`dak, farzand, farishta.
jahongir - dunyoni zapt etuvchi, g`olib, muzafar.
jo`ra - do`st, hamrohlik.

kabira - ayollarning ulug`i, buyugi bo`lsin, degan niyatda berilgan ism.
kabisa - taqvim bo`yicha kabisa yili to`rt yilda bir marta keladi; fevral oyida 28 kun emas, 29 kun bo`ladi. Ana shu 29-kuni
kabutar - aslida kaftar. o`zbek tilida kaptar ham deyiladi.
kavsar - jannatdagi buloqdan oquvchi suv.
kamola - etuk, barkamol
kenjabeka - eng so`nggi qizga qo`yiladigan ism.
kimyo - qimmatba;o narsalar, javohir- lar; kamyob, noyob, nodir, tengsiz.
kifoya - oilada ko`p qiz tug`ilgach, chaqaloqqa beriladigan ism.
komil - mukammallik, benuqsonlik, etuklik
komila - etuk, mukammal; zukko.
kumush – forslar nuqra degan ma`danni o`zbek tilida kumush deyiladi.
kabir - ulug`, ulkan.
kamol - etuk, mukamal, nuqsonsiz.
kamtar - odobli.
kozim - sabrlilik, chidamlilik, vazmin;
komron - baxt, saodat; maqsadga erishuvchi; hokimlik, hukmronlik.

lazzat - kelajakda hayoti huzur-halovatli bo`lsin, degan niyatda berilgan ism.
laylo - tun orasida tug`ilgan chaqaloqqa shunday ism berilgan
lobar - go`zal, kelishgan, yoqimtoy, ko`rkam. ismning shakllari
lola - bu ism o`zbek va tojik oilalarida keng tarqalgan.
lutfi - iltifot, nazokat, nafosat.
laziz - yoqimtoylik, shirin bola.
latif - muloyimlik, poklik, pokizalik; muloyimlik, mehribonlik.
lashkar - aynan: qo`shin.
lutfiddin - din iltifoti, marhamati.
luqmon – bilimdonlik, donolik.

mavlon - ustoz, valene`mat.
majid - atoqli, shuhratlilik, dongdorlik.
malik - podshoh, hokimlik, qirollik.
mansur - ustun turuvchi, g`olib, muzaffarlik.
maxtum - muhrlangan, mustahkam.
ma`mur - 1. biron ishga buyurilgan kishi. 2. obod.
ma`ruf - 1. Taniqlilik, bilingan, mashhurlik, atoqli. 2. Aqlga muvofiq, sharoitga mos va maqbul hisoblangan fe`l-harakat.
mashrab - xosiyatli, tabiatli, xulqli, odatli, xislatli, maylli, ravishlik.
mahmud - maqtalgan, maqtovga sazovor.
mahram - sirdoshlik, hamdamlik, mehribon do`st.
mahsud - - maqsadli, irodali.
mahsun - mustahkam, mahkamlangan, berk, himoyalangan.
mehriddin - din sharofati bilan erishilgan bola deb izohlash mumkin.
miraziz - izzatli mansabdor, amir. 
mirza - kotib; ilmli. 
muzaffar - g`olib. zafar qozonish. 
murod - maqsad, talab. 
muslim - islom diniga bo`ysungan, musulmon, taqvodor.
muso - yahudiylar payg`ambari
mustafo - tanlanganlik, saralab olingan. 
muxtor - mustaqillik, erkinlik. 
muhammad - maqtovga loyiq. payg`am- barimizning ismi.
muhiddin - dinni qo`llovchi, jonlantiruvchi, dinga go`zallik, nafosat bahsh etuvchy
mavjuda - agar go`dak nozikroq tug`ilgan bo`lsa.
mavluda - muhammad sollolohu alayhi vassalam muharram oyining dushanba kunida tug`ilgan agar chaqaloq shu oyda tug`ilgan bo`lsa mavluda ismi berilgan
maktuba - ba`zi oilalarda shunday ism beriladi, ammo ismning ma`nosi tushunar- siz;
malak - farishta.
malika - qirolicha.
mamlakat - diyor, vatan; mulk.
manzara - ko`rinish; ismning istilohiy ma`nosyni zebolik deb izohlash mumkin.
manzarat - iltifot, e`tibor.
manzura - husni axloqi bilan elga manzur bo`lsin degan niyatda berilgan ism.
mansuba - munosib, arziydigan.
mansura - asil ma`nosi golib, muzaffar.
marvarid - dur, inju.
marjon - marvarid tizimi.
marg`uba - qo`msalgan, istalgan, suyukli, qadrli.
marhabo - oilada uzoq vaqt kutilgan qizga shunday ism qo`yiladi.
marhamat - hudoning lutfi, iltifoti ma`nosida berilgan ism.
mastura - aynan: berkitilgan, yashiringan, pardali.
masuba - yaxshilikka intiluvchi, yaxshilik qiluvchi; muruvvatli.
mas`uda - baxtli, saodatmand.
matluba - iltijo bilan erishilgan, orzu qilingan.
maftuna - maftun etuvchi, zavqlantiruvchi chiroyli
maxsuma - sof, pokiza, gunohsiz. 
ma`mura - farovonlik deb izohlash mumkin.
mamura - farovonlik deb izohlash mumkin.
mashkura - shukr qiluvchi, shukrona aytuvchi.
mashhura - taniqli, obro`-e`tiborli bo`lsin degan niyatda beriladigan ism.
mahliyo - jozibali, jozibador.
mahmuda - maqgovli, e`zozli.
mahorat - isge`dodli, uddaburro, chaqqon,
mehmongul - o`zbeklarda yangi tug`ilgan chaqaloqni mehmon, deb ataladi.
mohira - iste`dodli, uddaburro, chaqqon
muazzam - katta, ulug`.
mubina - ochiq, ravshan.
mukarrama - izzat va xurmat sohibasi.
munavvara - multajiba ismning aynan ma`nosi.
munira - nurli, ravshan.
munis - do`st, o`rtoq, sirdosh.
munojot - farzandni uzoq yillar mobaynida kutgan oilalarda shunday ism beriladi.
musallam - sidqidil, itoatkor; yuvvosh.
musina - yoshi ulug degani.
muslima - musulmon, xudojo`y, taqvo- dor.
muxbira - xabar keltiruvchi, ya`ni oilaga omad keltiruvchi degan ma`noda beriladigan ism.
muxlisa - hayotda ixlos bilan yashasin degan niyatda beriladigan ism.
muyassar - hudo ato etgan farzand yoki hayotda ko`p narsaga erishsin, degan niyatda beriladigan ism
muqaddas - tabarruk, aziz yoki muqaddas qadamjolarni ziyorat qilgandan keyin tug`ilgan go`dak.
muhabbat - bu ismning berilish sababi ikki sevishgan qalbga bog`liq bo`lsa kerak.
muhayyo - iltijolarimizni hudo hozir qildi, degan ma`noda beriladigan ism
muhriniso - badanida biror belgi bo`lsa yoki ko`p qiz tug`ilgan bo`lsa shunday ism beriladi.
muhsina - mehribon, yaxshiliklar qiluvchi, rahmdil.
muhtaram - hurmatli, qadrli, yuksak e`zozga sazovor
mo`mina - shariat qoidalariga binoan yashaydigan, taqvodor.
mo`tabar - hurmatli, aziz.

navoiy - ziyoli oilalarda hazrat alisher navoiyning nomini yangi tug`ilgan go`dakka qo`yish odati bor.
navro`z - qadimiy ismlardan biri. navro`z kunida tug`ilgan go`daklarga shunday ism qo`yish odati bor.
nazar - hudo yoki avliyolar nazari bilan tug`ilgan bola. 
nazrullo - hudoga nazir qilingan, sadaqa qilingan bola.
naim - baxt, omad, saodatmandlik.
namoz - ehtimol ibodat paytida tug`ilgan bolaga shunday ism qo`yilgan. 
narimon - ehtimol nuriiymon bo`lishi mumkin. 
nasim - engil shabada, tong shamoli. 
nasriddin - dinning g`olibligi, dinning zafari.
ne`mat - nasibali, rizq-ro`zli
niyoz - 1. hudodan iltijo qilib olingan bola
nizom - tartibli, intizomli. 
nishon - badanida biron belgi bilan tug`ilgan. 
nodir - kamyoblik, noyoblik, bebaholik, tengsizlik. 
nosir - ko`makchilik, yorlamchilik yoki g`olib, muzaffar.
nur - yog`du, ziyolik, ravshanli
nusrat - g`oliblik, muzaffarlik.
nuh - aslida nuho – aql, xirad, zehn.
nazira - baxshida.
nazokat - latofatlilik, noziklik, latiflik.
naima - iqboli baland, saodatmand.
nargiz – aslida nargis. yunonlar bo`tagulni nargis deganlar.
nasiba - hudo bergan nasiba yoki rizq-ro`zli.
natija - uzoq vaqt farzand umidida hudoga iltijo qilish natijasi o`laroq tug`ilgan go`dak.
nafisa - nozik, xushtabiat.
nigina - uzuk.
nigor - rasm, surat, tasvir; go`zal.
nilufar - savsan. suv yuzasida yurgan nilufar g`oyatda chiroyli.
nihol - o`suvchi, yashovchi.
nodira - tengsiz, noyob.
noila - hudoga iltijo qilingandan keyin marhamat qilingan farzand.

obid - toat-ibodat qiluvchi, taqvodor.
odil - haqgo`y, adolatli, insofli, to`g`ri, halol.
odina - juma kuni tug`ilgan bolaga shunday ism qo`yish rasm bo`lgan.
ozod - erkinlik, hurlik, holilik.
olim - bilimli, bilimdonlik, donishmandlik.
omon - omon bo`luvchi, najot topuvchi.
orif - bilimdonlik, aqlli, dono yoki xudojo`y.
osim - qo`riqlangan, himoyalangan, muhofaza qilingan, xavfsiz.
obida - taqvodor, xudojo`y, mutaassib.
ozoda - ko`p manbalarda bu ismni erkin, hur, deb talqin qiladilar.
oy – go`zal ma`nosida
oysha - yashovchi, barhayot, joni qattiq.
olima - bilimdon bo`lsin, degan niyatda berilgan ism.
olmos - eng qimmatbaho bezak, demak, oilaning bezagi.
omila - mohir, tadbirkor, uddaburron
orasta - ozoda, sarishta, toza, tiniq, pok.
osiyo - aynan: tegirmon.
ofiyat - sog, omon, tinch, xotirjam umr kechirsin.
oftob - hamisha oftobdek charaqlab tursin.
oqila - aqlli, farosatli, dono.

panji - oiladagi beshinchi bolaga berilgan ism.
parda - o`z pardasi (ko`ylagi) bilan tug`ilgan bola.
pahlavon - yon, biqin, qanot. - zo`r, kuchli, qudratli;
pirnazar - pirlar nazar qilsin degan.
po`lat - mustahkam ma`dan.
pari - go`zal.
pokiza - qarang: ma`suma.
popuk - chiroyli, shirin.
poshsha - podshoh – yurt egasi, rahbari, posho turk tilidan general degani

qumri - chiroyli sayradigan qush nomi, bu qush beozorligi bilan ham tanilgan.
qutbiniso - jozibador deb talqin qilish mumkin.
qodir - dinni qadrlovchi. 
qayyum - abadiy mavjud.
qalandar - tarkidunyo qilgan odam.
qambar - to`rg`ay.
qahramon - o`zbeklarda qaramon urug`i ham bor.
qiyom - etilish, oftobning tikkaga kelgan payti.
qobil - iste`dodli, qobiliyatli; kuchli, qudratli;
qosim - taqsimlovchi.
quddus - pok, pokiza, begunoh, muqaddas, aziz.
qudrat - quvvatli, kuchli, qodir.
qurbon - qurbon hayiti kunida tug`ilgan bola. 
qutbiddin - dinning asosi, tayanchi.

ra`no - qizil gullarning bir turi ra`no deb ataladi.
rano - qizil gullarning bir turi ra`no deb ataladi.
risolat - edchilik, payg`ambarlik avlodiga mansub go`daklarga shunday ism beriladi.
ruxsora - yonoq, yuz, chehra.
ruqiya - sehr, tumor.
ravshan - yorug`, shu`lali; tiniq, beg`ubor; g`amsiz.
rajab - hijriy yilning - to`r- tinchi oyida tug`ilgan bola.
razzoq - rizq beruvchi.
ramazon - qamariy yil hisobining to`qqizinchi oyida tug`ilgan bolaga shunday ism beriladi. 
rasul - elchi.
rauf - muloyimlik, shafqatlilik, rahmdillik. 
rashid - to`g`ri yo`ldan yuruvchi. 
rahim - mehribonlik, marhamatlilik
rahima - muruvvatli, shafqatli.
rahmat - mehribonlik, marhamatlik. 
rahmon - o`ta mehribonlik. 
rixsitilla - tilladek qimmat, qadrli.
ruslan - arslon sher.
rustam - ulkan gavdali, qudratli, dovyuraklik, bahodirlik
ruhiddin - dinning ruhi.

sabina - qadrli, qimmatli, suyukli.
sadoqat - vafodor, sodiq; chin, samimiy do`st
said - baxtli, saodatli.
saida - baxtli, saodatmand.
saidiniso - hudo yo`liga boshlovchi.
saiyora – tez harakat qiluvchi yulduz; planetaning nomi
sayida - sayidlar, aslzodalar naslidan.
saltanat - aynan: hokimiyat, hukmronlik
samina - qadrli, izzat-obro`li.
samira - suhbatdosh, dilkash.
sanam - ma`buda.
sanobar - qarag`ayga o`xshagan xushqomat daraxt.
saodat - baxtli, baxtiyor, iqboli baland. - x
sarvi - to`g`ri, tik o`sadigan, qishin-yozin ko`m-ko`k turadigan, hidi yoqimli, xushqomat bir daraxt.
sitora - aynan yulduz.
soliha - yaxshi xislatlarga ega, maqbul.
soniya - oiladagi ikkinchi farzand, ikkinchi qizga shunday ism berilishi odati bor
sohiba - ega, beka.
surayyo - yulduzdek porloq
sabriddin - dinning sabr-toqatli kishisi.
sadr - baland martabali, mansabdor.
sayid - aynan: ega, xo`ja, boshliq, rahbar. 
sayfi - qilich, shamshir.
salim - sog`lom. 
saloh - rost, to`g`ri, halol; haqgo`y.
samandar - o`tda yonmaydigan.
samar - hosil, natijali, mevali.
sanjar - sanchmoq,shiddatli,o`tkir. 
sarvar - yo`lboshchi, boshliq, rahnamolik. 
sardor - etakchilik, boshliq. 
safar - safar oyi (musulmonlar taqvimining ikkinchi oyi)da tug`ilgan. 
siddiq - to`g`ri so`z, sofdil, rostgo`y.
siroj - yorug`, nurli, chiroqli.
sobir - sabr, toqat. 
sobit - mustahkamlik, mahkamlik. 
sodiq - chin do`st. 
solih - pok, halol, pokiza.
sohib - to`gri talaffuzi.
sulaymon - himoyalangan, berk, muhofazaga olingan,
sunnat - yo`l, odat, udum, taomil yoki sunnati o`zi bilan tug`ilgan bola.
suhrob - qizil yog`du; la`l, yoqut. 

tabassum - hamisha chiroyi ochiq bo`lsin, degan niyatda beriladigan ism.
toira - yuksak-yuksakdarga uchuvchi qush.
toyiba - pokiza, ozoda, ma`suma; mehribon, rahmdil.
toliba - hayotda hunarlar, ilmlar sari intiluvchi bo`lsin, degan niyatda beriladigoan ism.
tohira - tahoratli; pokiza, dili toza, pokdomon, taqvodor.
tarxon - turli majburiyatlardan (soliqlardan) ozod qilingan.
tilla - oltindek qimmatli.
toji - biron xol bilan tug`ilgan bola. 
toir - qush; parvoz qiluvchi, yuksaklikka ko`tariluvchi.
toyib - pokizalik, ozodalik.
tolib - bilim izlovchi, bilim ixlosmandi. 
tohir - tahoratli, pokizalik; beg`uborlik.
turob - xok, tuproq. 

ubayda - lugaviy ma`nosi kichik qul (cho`ri) bo`lsa x,am, ismni hudoning xoksor bandasi, deb
umida - birinchidan, uzoq yillar kutilgan farzandga shunday ism beriladi.
umira - umri uzoq bo`lsin degan niyatda beriladigan ism
ubay - - qul, qul bola.
umar - barhayot, yashovchi.
umid - orzu qilingan, kutilgan.
usmon - singan-chiqqanlarni davolovchi tabib.

vali - avliyo, do`st, taqvodorlik.
vasliddin - diniy maqsadga intiluvchi.
vafo - sadoqatlilik.
vahhob - saxiylik, jo`mardlik.
vohid - yagonalik, ajralib turish, beqiyos ma’nosida keladi.
vasila - “vasl” so`zidan. etishish, orzuga erishish
vohida - yagona, yolg`iz.

xabira - aqlli, bilimdon, xabardor.
xosiyat - agar chaqaloq tug`ilmasdan oldin, onasi homiladorlik paytida otaning ishi yurishib ketib, unga omad kulib boqqan bo`lsa, tugilgan chaqaloqqa shunday ism berilishi mumkin.
xumor - qiz tug`ilishini orzu qilgan yoki farzandga mushtoq bo`lgan oilalarda.
xurshida - oftobmonand.
xalil - do`st, suyukli.
xatib - va`zgo`y, va`zxon.
xoja - hurmatli, e`tiborli yoki xo`jayin.
xolis - samimiy, beg`araz, sofko`ngil. 
xoliq - bunyodkor, ijodkor.
xurram - shod, shodmon, xursand, xush- kayfiyat.
xursand - shod, baxtiyor. 
xurshid - quyosh.
xushbaxt - saodatmand.
xo`ja - sohib, janob.

yetmishxon - otasi etmishga kirganda tugilgan chaqaloqlarga shunday ism berilish odati bor. yobonoi - o`zbeklar cho`l, sahro, dala, dasht deganni fors tilida yobon deyiladi
yodgora - chaqaloq tug`ilishi bilan onasi qazo qilsa. 
yorqin - Hayoti (kelajagi) porloq, nurga to‘la bo‘lsin yoki mehrli, muruvvatli, samimiy, ko‘ngli ochiq bola.
yorqinoy - iqboli nurli va nurafshonli.
yoqut - qizil rangli qimmatbaho tosh, uni rubin ham deydilar. 
yo`ldoshoy – avval tug`ilgan farzandlarga yoki ota-onasiga hamroh bo`lsin
yodgor - tug`ilishdan oldin yoki tug`ilgandan keyin otasi yoki onasi qazo qilgan bolalarga qo’yiladigan ism.
yagona - yolg`izgina, tanhogina, bitgagina.
yayra - erkin, hur yashasin degan niyatda beriladigan ism.

zamina - zamin, er farzandi bo`lsin degan niyatda berilgan ism. 
zamira - ich, yurak, ko`ngil, dil.
zarifa - aqlli, farosatli, pokiza, ma`suma degan ma`nolarda. 
zahro - yorqin, ravshan, nurli, oq yuzli yoki intiluvchi. 
zebi - chiroyli, go`zal. 
ziyoda - agar go`dakning ortig`i bo`lsa, o`g`il bolalarga ortiq, ziyod, qiz bolalarga ziyoda degan ism qo`yilgan.
zilol - tiniq va muzdek suv degani. 
zohida - dindor, taqvodor, xudojo`y, mo`mina.
zohira - namoyon, ochiq, ravshan, porloq.
zubayda - biron narsaning yaxshi tomoni; sarasi; yaxshi natijasi
zulayho - taxminan: kichik, kenja qiz
zulfi - ayollarning ikki chekkasidan tushib turgan soch kokillari, umuman, ayollarning sochi. “
zumrad - yashil tusli qimmatbaho tosh.
zuhro - yorug` sayyoraning nomi
zabihullo - hudoga atalgan, sadaqa qilingan, qurbonlik.
zavqiddin - zavqli, lazzatli.
zaynobiddin - zayni (ko`rkam, zo`zal, ziynat) so`zi bilan bog`liq.
zarif - poklik, tozalik; nozikfahmlik, ziyraklik,
zafar - g`olib. muzaffar qilish.
zahiriddin - bemorlik, ranj, azob, mashaqqat, panoh, posbon, iqbol.
ziyod - umr ziyoda, uzoq bo`lsin degan niyatda shunday ism beriladi.
zoid - ortiq, ziyoda.
zoir - ziyoratchi.
zokir - zikir ismi o`zgargan shakli.
zohid - tarkidunyo qilgan taqvodor.
zohir - ko`ringan, ko`rimlilik, ochiqlik, ravshanlik.
zulfiqor - teshib o`tuvchi. qilich.
zuhriddin - zohir ismining o`zgargan shakli; dinning ko`rinishi, oshkoraligi.

o'ktam - Mehr-muruvvatli, g‘amxo‘r, mehribon, oqibatli yoki mag‘rur, viqorli, mustaqil, erkin.

g`ayrat - mehnatsevar deb izohlash mumkin.
g`afur - gunohlarni kechiruvchi, rahmdil, marhamatli, mag`firatli
g`iyos - faryod, ovoza, kuch, tayanch.
g`olib - engilmas, muzaffar, enguvchi. 
g`ulom - 1. qul. 2. farzand, o`g`il. 

shabnam - pok, pok- domon bo`lsin, degan yaxshi niyatda beriladigan ism.
shavqiya - o`z hayotini zavq bilan o`tkazsin, degan niyatda berilgan ism.
shamshod - shamshod daraxti hamisha yashnab, tik o`sadi. shunga nisbatan berilgan ism.
sharifa - ilohiy, muqaddas, aziz, e`zozli; sharaflangan.
sharofat - sharafli, aziz, qadrli, sara, maqbul.
shahlo - agar chaqaloq ko`zlari katta-katta tug`ilsa, unga shunday ism beriladi.
shahnoz - bu ism, masalan, o`zbek oilalarida keng tarqalgan, aksariyat kizlar shu nom bilan ataladi.
shahodat - guvohlik beruvchi.
shoira - she`r yozuvchi degani.
shavkat - sharaf, shonli, kuch.
shahboz - shunqor, lochin. shahvor - shohona, shohlarcha.
shahob - nurli yulduz.
sherzod - sherdek qudratli, jasur, qaytmas.
shokir - farzand berganiga hudoga shukrona ma`nosida.
shukur - xudodan minnatdorlik. 
shuhrat - mashhurlik; shon-shavkat. 
shuxrat - mashhurlik; shon-shavkat. 
shahzod - shohlar nasliga mansub bola, podshoh o‘g‘li, boy. Zodagon, sardor, hukmron va qirollardek savlatli, viqorli, obro‘-e’tiborli.

chilton - qirqta ajralmas ruh. 
chingiz – buyuk, qudratli. 
chori - oiladagi to`rtinchi farzand yoki choriyorlarga nisbat berilgan. 
cho`lpon - tong yulduzi, yorug` yulduz.
chinnigul - gulning bir turi. 
charos - Katta qora ko‘zli qiz, ko‘zlari charosdek chiroyli, fusunkor, jozibali, nafis, latofatli, suluv va go‘zal qiz.
cho`lpon – tong yulduzi, yorug` yulduz. 